{
  "1": {
    "1": 0,
    "2": 1,
    "3": 2,
    "4": 3,
    "5": 4,
    "6": 5,
    "7": 6,
    "8": 7,
    "9": 8
  },
  "2": {
    "1": 10,
    "2": 11,
    "3": 12,
    "4": 13,
    "5": 14,
    "6": 15,
    "7": 16,
    "8": 17,
    "9": 18
  },
  "3": {
    "1": 20,
    "2": 21,
    "3": 22,
    "4": 23,
    "5": 24,
    "6": 25,
    "7": 26,
    "8": 27,
    "9": 28
  },
  "4": {
    "1": 29,
    "2": 30,
    "3": 31,
    "4": 32,
    "5": 33,
    "6": 34,
    "7": 35,
    "8": 36,
    "9": 37,
    "10": 38,
    "11": 39,
    "12": 40
  },
  "5": {
    "1": 42,
    "2": 43,
    "3": 44,
    "4": 45,
    "5": 46
  },
  "7": {
    "1": 48,
    "2": 49,
    "3": 50,
    "4": 51,
    "5": 52,
    "6": 53,
    "7": 54
  },
  "8": {
    "1": 56,
    "2": 57,
    "3": 58,
    "4": 59,
    "5": 60,
    "6": 61,
    "7": 62,
    "8": 63,
    "9": 64,
    "10": 65
  },
  "9": {
    "1": 67,
    "2": 68,
    "3": 69,
    "4": 70,
    "5": 71,
    "6": 72,
    "7": 73,
    "8": 74,
    "9": 75,
    "10": 76,
    "11": 77,
    "12": 78,
    "13": 79,
    "14": 80
  },
  "10": {
    "1": 82,
    "2": 83,
    "3": 84,
    "4": 85,
    "5": 86,
    "6": 87,
    "7": 88,
    "8": 89,
    "9": 90,
    "10": 91,
    "11": 92,
    "12": 93,
    "13": 94
  },
  "11": {
    "1": 96,
    "2": 97,
    "3": 98,
    "4": 99,
    "5": 100,
    "6": 101,
    "7": 102,
    "8": 103,
    "9": 104,
    "10": 105,
    "11": 106,
    "12": 107,
    "13": 108
  }
}
